150
Nico	Allcorn	3C
Andriette	Berkeley	4D
Dagmar	Adamovich	2F
Martita	Glaum	3D
Ursa	Halfhide	3B
Curry	Domokos	4B
Sayre	Yuille	4B
Melony	Ruger	5B
Antonina	Eneas	4D
Jennica	Mitchenson	1B
Agneta	Pioch	5B
Erny	Bexley	5F
Waverly	Mountford	5F
Gregoire	Iacovuzzi	5E
Reena	Wohlers	1C
Tate	Korbmaker	1C
Cynthy	Choppen	3A
Reeta	Clere	2E
Nanette	Gonnely	2E
Skipp	Wharby	2F
Duane	Zuan	3E
Stevena	Stebbin	2D
Drona	Rudkin	2E
Evy	Thripp	2B
Netta	Dalzell	2C
Melicent	McCaughen	2D
Nadine	Swayton	1A
Adam	Forestel	1F
Malory	Ciciotti	2A
Binni	Batting	5E
Allyce	Harewood	1B
Rowan	Embra	1E
Hanson	McCaughey	1E
Stanton	Benge	3F
Traver	Gantz	2B
Dody	Eichmann	1B
Berthe	Hanretty	1A
Anastasie	Schohier	5F
Evangelin	Egdal	3F
Kippie	McVeagh	5A
Winifield	Rothert	5F
Annmarie	Girdler	4B
Rosita	Janatka	5E
Orella	Farnan	3E
Olivette	Acutt	2E
Jarvis	Etheredge	5C
Kettie	Bonome	1B
Tatiania	Jeal	4D
Vance	Currin	5C
Elinore	Buckleigh	3E
Kalvin	Storms	3F
Chicky	Castelletti	1F
Delia	Losel	3B
Kellen	MacMaster	3F
Barbabra	Sutterfield	4F
Arny	Tape	4C
Dionne	Daynter	4C
Waiter	Ruscoe	3D
Audy	Hannabuss	1C
Walker	Storcke	2E
Roseanna	Haily	2D
Falito	Hagard	1C
Lorie	Cellier	3A
Paulie	Yeliashev	3F
Gracia	Yarmouth	2A
Isis	Rummery	3A
Ingar	Needs	4D
Dyane	Brimilcombe	4F
Ike	Petters	1A
Robinson	Van-der-Beken	5B
Bennett	Shapland	2B
Onofredo	Oty	3C
Kerk	Coaten	4F
Jillene	Peacop	3B
Rafferty	Stuehmeyer	2D
Aubree	Bellord	4B
Lacey	Urrey	1C
Giffy	Hedworth	4B
Sophey	O'Corrin	1B
Tonya	Smittoune	1A
Mike	Eckersley	4C
Anabella	Ringe	3D
Raddie	Bodill	4B
Lyndy	Rubery	3A
Bartholomew	Larvent	2B
Manon	Whitcomb	4B
Arlee	Van-Halen	1C
Garnet	Lapham	5F
Josephine	Waterhouse	1A
Celinka	Borgars	1D
Bar	Pallas	5C
Giselle	Werrett	5D
Horatia	Cornwall	5D
Reed	McNee	2A
Corabelle	Darbey	2A
Leighton	Cake	3F
Vernice	Dinnis	4B
Giorgio	Balharry	2B
Avrit	Grouvel	1A
Tamarah	Jost	4C
Franklyn	Tissell	5B
Johan	Vaggers	4D
Janeczka	Roubay	3A
Trumaine	Bertrand	1E
Gisela	Scimoni	3C
Margery	Marskell	5E
Antonina	Cleare	4A
Elsinore	Cuddihy	3C
Cordelia	Passmore	1C
Bekki	Govett	3C
Gino	Hawkins	4D
Broddy	Forman	3A
My	Leate	5C
Kass	Shafe	4A
Ros	Belcham	5C
Debor	Durnan	5C
Meris	Rabb	4C
Pattie	Collyer	2C
Betta	Josefsson	5E
Desi	Starmont	2C
Ally	Bartkowiak	5F
Cully	Kearford	4C
Anselm	Bockman	2D
Xylina	Jacobowits	2F
Ulrich	Bridle	2A
Valentijn	Muzzini	3C
Debora	Benaine	2D
Harriett	Lawleff	2E
Anabelle	Lotze	2A
Dev	Ouslem	4C
Carol-jean	Reinbeck	1A
Benedetta	Comizzoli	1A
Field	Matzkaitis	4A
Izak	Bennet	3B
Budd	Snalom	5E
Reba	Draper	2D
Elora	Tolwood	5A
Nelie	Linnitt	1E
Britt	Hierro	4B
Jozef	Stalman	1F
Anthia	Wimbush	5C
Gwendolyn	Daveridge	3B
Tabor	Rathke	2E
Brenden	Owenson	4D
Nicol	Gollard	3E
Zane	Jaggi	4E
Ernesta	Hawkslee	1D
Ulick	Annell	1D
Harry	Ladloe	5C
Katharine	Spraging	1F
