20
Flossy	McGairl	Physics,
Gregor	Yerson	English,Music,Spanish,
Britni	Peotz	French,Mathematics,
Dino	Grinyer	Biology,IT,English,
Kimberley	Maneylaws	Physics,Mathematics,
Prudence	Klampk	History,Arts,Physics,Mathematics,Music,
Arabela	Coper	Biology,Physics,Spanish,English,Music,
Irving	Dandie	Spanish,
Nial	Plewright	English,
Lotty	Heeney	French,English,PE,Biology,Arts,
Roberto	Cords	Chemistry,
Dorise	Hurlin	French,Music,Spanish,PE,History,
Ira	Waby	English,Arts,French,History,Music,
Demetra	Kenneford	Music,IT,Chemistry,Spanish,Physics,
Christie	Guichard	English,Physics,Chemistry,Mathematics,
Humberto	Garlic	Arts,
Yasmeen	McAuley	English,
Dimitri	Stitt	Spanish,
Eduard	Bellelli	Arts,
Derrek	Moir	Arts,Spanish,English,
